NO textures/north_texture.xpm
SO textures/south_texture.xpm
WE textures/west_texture.xpm
EA textures/east_texture.xpm
F 220,100,0
C 225,30,0

1111111111
1000000001
1011000001
100N000001
1111111111